9999999999999999
9111911111111119
9111911119111119
9111111111111119
9111111119111119
9111911111111119
9111111111111119
9999999999999999 